30 36
####################################
#..................###.............#
#.####.###########.....#######.###.#
#.####.#...........###.....# #.###.#
#........###.#####.....#.#.###.# #.#
#.#####.####.#   ###.###.#.#.#.# #.#
#.#   #...##.#     #.###.#.#.#.# #.#
#.#   #.#.##.#     #.###.#...#.# #.#
#.#####.#.##.#######.###.#####.###.#
#..................................#
#.#######.###.####.##BBB##.#.#####.#
#.###  ##.###.####.##BBB##.#.##.##.#
#.#### ##..........##BBB##.#.##.##.#
#.## ####.##.##.##.#######.#.##.##.#
#.........##....##.#######.#.#..##.#
#.#######....##....##...##.#...###.#
#.#######.##.##.##.##.####.##.####.#
#..........................#.......#
#.######.#################.###.###.#
#.#    #.#               #.........#
#.######.#  ###     ###  #.###.# #.#
#........#  ###     ###  #.# #.# #.#
#.######.#     ####      #.# #.###.#
#......#.#################.###.....#
#.######.#...................#.###.#
#..........#########.#######.#.# #.#
#.##.####.##########.#     #...# #.#
#.##.####.##.........#######.#.###.#
#............#######.........#.....#
####################################
